# 0=ABYSS
# 1=FLAT
# 2=EDGE_N
# 3=EDGE_NE
# 4=EDGE_E
# 5=EDGE_SE
# 6=EDGE_S
# 7=EDGE_SW
# 8=EDGE_W
# 9=EDGE_NW
# a=EDGE_ABYSS
# b=TEST
0,0,0,0,0,0,0,0,0,0,0,0,0,0,0,0
0,9,2,2,2,2,2,2,2,2,2,2,2,2,3,0
0,8,1,1,1,1,1,1,1,1,1,1,1,1,4,0
0,8,1,1,1,1,1,1,1,1,1,1,1,1,4,0
0,8,1,1,1,1,0,1,1,1,1,1,1,1,4,0
0,8,1,1,1,1,1,1,1,1,1,1,1,1,4,0
0,8,1,1,1,1,1,1,1,1,1,1,1,1,4,0
0,7,6,6,6,6,6,6,6,6,6,6,6,6,5,0
0,a,a,a,a,a,a,a,a,a,a,a,a,a,a,0
0,0,0,0,0,0,0,0,0,0,0,0,0,0,0,0